2 2 2 2 2 2 2 2 2 2 2 2
2 1 1 1 6 6 6 6 6 6 6 2
2 1 1 1 1 1 1 1 1 1 6 2
2 1 1 5 1 1 1 1 1 1 1 2
2 1 5 4 5 1 1 1 1 1 1 3
2 1 1 5 1 1 1 1 1 1 1 2
2 1 1 1 1 1 1 1 1 1 1 2
2 1 1 1 1 1 1 1 5 1 1 2
2 1 1 1 1 1 1 5 4 5 1 2
2 1 1 1 1 1 1 1 5 1 1 2
2 1 1 1 1 1 1 1 1 1 1 2
2 2 2 2 2 2 2 2 2 2 2 2